111111111111
100100000EC1
1000001110C1
1P0011000001
111111111111