111111111111111111
1P001C111001000C11
1010101C00010101E1
1C1000000000010001
111111111111111111