111111111111111111111
10001C111001000C100P1
1010101C00010101E1001
1C1000000000010000001
111111111111111111111