111111111111111111111
100000000000000000001
100000000000000010001
1000000C00P00001E1001
100000000000000000001
111111111111111111111